stumbleupon	../scripts/crawler/output/organizations//stumbleupon.json
scribd	../scripts/crawler/output/organizations//scribd.json
lala	../scripts/crawler/output/organizations//lala.json
sugar	../scripts/crawler/output/organizations//sugar.json
tvtrip	../scripts/crawler/output/organizations//tvtrip.json
kaboodle	../scripts/crawler/output/organizations//kaboodle.json
indeed	../scripts/crawler/output/organizations//indeed.json
textpayme	../scripts/crawler/output/organizations//textpayme.json
vudu	../scripts/crawler/output/organizations//vudu.json
judysbook	../scripts/crawler/output/organizations//judysbook.json
snapfish	../scripts/crawler/output/organizations//snapfish.json
scrybe	../scripts/crawler/output/organizations//scrybe.json
veoh	../scripts/crawler/output/organizations//veoh.json
crowdfactory	../scripts/crawler/output/organizations//crowdfactory.json
socialthing	../scripts/crawler/output/organizations//socialthing.json
cloudant	../scripts/crawler/output/organizations//cloudant.json
gbox	../scripts/crawler/output/organizations//gbox.json
alibaba	../scripts/crawler/output/organizations//alibaba.json
fathom-online	../scripts/crawler/output/organizations//fathom-online.json
frazr	../scripts/crawler/output/organizations//frazr.json
magnify	../scripts/crawler/output/organizations//magnify.json
myndnet	../scripts/crawler/output/organizations//myndnet.json
seedcamp	../scripts/crawler/output/organizations//seedcamp.json
aviary	../scripts/crawler/output/organizations//aviary.json
moz	../scripts/crawler/output/organizations//moz.json
mimeo	../scripts/crawler/output/organizations//mimeo.json
sayhired-inc	../scripts/crawler/output/organizations//sayhired-inc.json
3jam	../scripts/crawler/output/organizations//3jam.json
deca-tv	../scripts/crawler/output/organizations//deca-tv.json
rupture	../scripts/crawler/output/organizations//rupture.json
fon	../scripts/crawler/output/organizations//fon.json
songbird	../scripts/crawler/output/organizations//songbird.json
guardiananalytics	../scripts/crawler/output/organizations//guardiananalytics.json
code-42-software	../scripts/crawler/output/organizations//code-42-software.json
laszlosystems	../scripts/crawler/output/organizations//laszlosystems.json
casero	../scripts/crawler/output/organizations//casero.json
merchantcircle	../scripts/crawler/output/organizations//merchantcircle.json
trackvia	../scripts/crawler/output/organizations//trackvia.json
vobile	../scripts/crawler/output/organizations//vobile.json
movenetworks	../scripts/crawler/output/organizations//movenetworks.json
billeo	../scripts/crawler/output/organizations//billeo.json
trustedid	../scripts/crawler/output/organizations//trustedid.json
mypublisher	../scripts/crawler/output/organizations//mypublisher.json
deezer	../scripts/crawler/output/organizations//deezer.json
jacked	../scripts/crawler/output/organizations//jacked.json
ausra	../scripts/crawler/output/organizations//ausra.json
nanosolar	../scripts/crawler/output/organizations//nanosolar.json
bluepulse	../scripts/crawler/output/organizations//bluepulse.json
journeys	../scripts/crawler/output/organizations//journeys.json
oversee	../scripts/crawler/output/organizations//oversee.json
fifthgenerationsystems	../scripts/crawler/output/organizations//fifthgenerationsystems.json
invitemedia	../scripts/crawler/output/organizations//invitemedia.json
currenttv	../scripts/crawler/output/organizations//currenttv.json
salesforce	../scripts/crawler/output/organizations//salesforce.json
gumgum	../scripts/crawler/output/organizations//gumgum.json
where-com	../scripts/crawler/output/organizations//where-com.json
tivo	../scripts/crawler/output/organizations//tivo.json
danger	../scripts/crawler/output/organizations//danger.json
epals	../scripts/crawler/output/organizations//epals.json
yadata	../scripts/crawler/output/organizations//yadata.json
clickpass	../scripts/crawler/output/organizations//clickpass.json
imperva	../scripts/crawler/output/organizations//imperva.json
posit-science	../scripts/crawler/output/organizations//posit-science.json
popularmedia	../scripts/crawler/output/organizations//popularmedia.json
supplyframe	../scripts/crawler/output/organizations//supplyframe.json
communicado	../scripts/crawler/output/organizations//communicado.json
authenticlick	../scripts/crawler/output/organizations//authenticlick.json
cogent	../scripts/crawler/output/organizations//cogent.json
socialmoth	../scripts/crawler/output/organizations//socialmoth.json
showclix	../scripts/crawler/output/organizations//showclix.json
mytrade	../scripts/crawler/output/organizations//mytrade.json
chipin	../scripts/crawler/output/organizations//chipin.json
workstreamr	../scripts/crawler/output/organizations//workstreamr.json
clearwell-systems	../scripts/crawler/output/organizations//clearwell-systems.json
weplay	../scripts/crawler/output/organizations//weplay.json
business-insider	../scripts/crawler/output/organizations//business-insider.json
marketo	../scripts/crawler/output/organizations//marketo.json
glasses-direct	../scripts/crawler/output/organizations//glasses-direct.json
trampoline-systems	../scripts/crawler/output/organizations//trampoline-systems.json
travel-ad-network	../scripts/crawler/output/organizations//travel-ad-network.json
lightpole	../scripts/crawler/output/organizations//lightpole.json
tunewiki	../scripts/crawler/output/organizations//tunewiki.json
cortera	../scripts/crawler/output/organizations//cortera.json
yoono	../scripts/crawler/output/organizations//yoono.json
marketlive	../scripts/crawler/output/organizations//marketlive.json
clairmail	../scripts/crawler/output/organizations//clairmail.json
think-passenger	../scripts/crawler/output/organizations//think-passenger.json
wavemaker-software	../scripts/crawler/output/organizations//wavemaker-software.json
sometrics	../scripts/crawler/output/organizations//sometrics.json
iconclude	../scripts/crawler/output/organizations//iconclude.json
roku	../scripts/crawler/output/organizations//roku.json
funambol	../scripts/crawler/output/organizations//funambol.json
ebureau	../scripts/crawler/output/organizations//ebureau.json
scribblelive	../scripts/crawler/output/organizations//scribblelive.json
tapatap	../scripts/crawler/output/organizations//tapatap.json
truste	../scripts/crawler/output/organizations//truste.json
aptera	../scripts/crawler/output/organizations//aptera.json
edufire	../scripts/crawler/output/organizations//edufire.json
sylantro	../scripts/crawler/output/organizations//sylantro.json
cozigroup	../scripts/crawler/output/organizations//cozigroup.json
